debut de niveau.txt


#level0
10
12
tileset map0.bmp
theme0.mp3
4881
323059
8 8 8 8 8 8 46 8 8 8 
8 45 29 8 46 25 46 8 8 8 
8 8 25 25 25 8 5 8 8 8 
8 8 25 148 143 5 46 8 45 8 
8 25 8 8 5 8 5 8 29 8 
8 8 8 29 8 8 46 5 8 8 
8 25 29 8 8 46 8 8 8 29 
8 143 8 25 46 25 25 5 6 8 
8 26 8 29 8 8 8 5 8 6 
8 8 8 46 8 8 160 8 8 29 
8 5 8 8 8 8 5 140 141 8 
8 8 8 8 8 5 8 8 8 8 E
64 104 104 104 64 84 64 104 104 64 
80 0 0 0 0 0 0 0 0 60 
80 0 0 0 0 0 0 0 0 60 
80 0 0 0 0 0 0 0 0 60 
80 0 0 178 179 0 0 0 0 60 
80 0 0 198 199 0 0 0 0 60 
80 0 178 179 555 556 557 558 0 60 
80 0 198 199 575 576 577 578 0 60 
80 0 0 0 0 0 0 0 0 60 
80 0 0 0 0 0 0 0 0 60 
80 0 0 0 0 0 0 0 0 60 
64 104 104 104 104 104 104 104 104 64 E
0 0 0 0 0 0 0 0 0 0 
0 0 0 0 0 0 0 0 0 0 
0 0 0 0 0 0 0 0 0 0 
0 0 0 0 495 496 0 0 0 0 
0 0 0 0 515 516 517 518 0 0 
0 0 0 0 535 536 537 538 0 0 
0 0 0 0 0 98 99 0 0 0 
0 0 0 0 0 118 119 0 0 0 
0 0 0 0 0 0 0 0 0 0 
0 0 0 0 0 0 0 0 0 0 
0 0 0 0 0 0 0 0 0 0 
0 0 0 0 0 0 0 0 0 0 E
111111111100000000045000000004500000000450011000045001111104501111110450111111045000000004500000000450000000041111111111

#level1
10
10
tileset map0.bmp
theme0.mp3
4881
323059
5 5 5 5 5 5 5 8 5 8 
5 143 5 5 5 5 8 5 5 8 
5 5 8 8 8 5 5 5 5 8 
5 8 8 8 5 8 8 148 5 5 
5 8 8 8 5 5 5 5 8 5 
5 8 5 8 5 141 5 8 5 5 
5 8 8 8 5 5 8 8 8 5 
5 5 8 8 5 8 5 5 8 5 
5 8 8 8 8 5 5 5 8 5 
5 5 5 5 5 8 8 8 5 5 E
2 2 2 0 0 0 0 0 0 2 
0 0 0 2 2 2 2 0 0 2 
0 0 0 2 0 0 0 2 0 0 
0 0 2 2 0 0 0 2 2 0 
0 2 2 2 0 0 0 0 2 0 
2 2 2 0 0 0 0 0 2 0 
2 0 0 0 0 0 0 0 0 2 
2 2 0 0 0 0 0 0 2 0 
0 0 2 2 0 0 0 0 2 0 
0 0 0 0 2 2 2 2 2 0 E
0 0 0 0 0 0 0 0 0 0 
0 0 0 0 0 0 0 0 0 0 
0 0 0 0 0 0 0 0 0 0 
0 0 0 0 0 0 0 0 0 0 
0 0 0 0 0 0 0 0 0 0 
0 0 0 0 0 0 0 0 0 0 
0 0 0 0 0 0 0 0 0 0 
0 0 0 0 0 0 0 0 0 0 
0 0 0 0 0 0 0 0 0 0 
0 0 0 0 0 0 0 0 0 0 E
1110000001000111100100010001000011000110011100001011100000101000000001110000001000110000100000111110

!
fin