fichier Niveau
contient les niveaux de l'aventure
#level1
111111111111111111111111111111111111111111111111111001111111111421111111111131111111222122212221211112112121222112112222112112112112222122212222
#level2
111111111111000000111111011110111111011110111111000010111111111420111111111130000001111101111101111101111101111101111101111100000101111111110001
#level3
111111111111111111111111111111111111110111111011115130011511110420002311110110011011115112211511110113311011115050050511111111111111100000000000
#level4
111110111111111110111111111110111111111113111111111112111111000324230000111112111111111113111111111110111111111110111111111110111111111110111111
#level5
300222222222000000000000002222222222202000000000202022222222202020000000202020222222202020200000202020202222202020202000202020202022202020202024
#level6
111111111111111101010101111101010101111101010101100011111111111111111111100011111111111111100011100011101011111111100010100011151020111111300324
#level7
000000000000000000000000000000000000000000000000000000000111000000011101000000111111000001150131000001102001000011112203000010130052000011111324
#level8
555550000111555500001111555000011111550000111111500001111101000011111001000111111201001111111320011111111022111110230110111100022110111111102004
#level9
320001320110110101110000310100011110210001010000011111010111000000010131111111010121000231010101101111010001001000010111011011110000000000000114
#levelX
111111111111111111111111111111111111111111111111111111111111111111111131111111110121000231110101101111110001001000010111011011110000000000000114

fin du fichier